########################
#......................#
#......................#
#......................#
#......................#
#......#########.......#
#......................#
#......................#
#......................#
#......................#
#......##########......#
#......................#
#...........#...#......#
#...........#...#......#
#...........#...#......#
#.......#####...#......#
#...............#......#
#...............#......#
#......................#
#......................#
#......................#
########################